111111111111111111
10010100001000111100000000001
10000000010011000111000000001
10001000000000000010101000001
11100010000001000000100000001
10011000000000000000111000001
11000010100010000000010101101
10001010000001000001110000001
10000010101000000000000100001
1100100000011010E000100000001
10001000100000000011001000011
10010000000000000101000111001
10100000011010011000001000001
10010010100100010101C11001001
10010010100100010010010000001
10110000100100000100001000011
10000011001000000001000000101
10001000000011100100100000001
10010101001001110001011000001
11001001010101000001100000001
11000101000000000101000101101
10100000000010000100001001011
11101001000011010001100100011
11000010000100000000000000001
10P00001100000000110010000001
11111111111111111111111111111
