11111111111111111111111111111
100101000010001111000000000E1
10000000010011000111000000001
10001000000000000010101000001
11C00010000001000000100000001
10011000000000C00000111000000
110000C0100010000000010101101
10001010000001000001110000001
10000010101000100000000100001
11001000000110100000100000001
10001000100000000011001000011
10010000000000000C01000111001
10100000011010011000001000001
100100C010010001010101C001001
100C0010100100010010010000001
10110000100100000100001000011
10000011001000000001000000101
1000C000000011100100100000001
10010101001001110001011000001
11001001010101000001100000001
11000101000000000101000101101
10100000000010000100001001011
11101001000011010001100100011
110000100001000000000000C0001
10P00001100000000110010000001
11111111111111111111111111111
