111111
1PN001
100C01
100C01
100C01
100C01
100C01
100C01
100C01
100C01
100C01
100C01
100C01
100C01
1C0C01
100C01
100C01
100C01
100C01
100C01
100C01
100C01
100C01
100C01
100C01
100C01
100C01
100C01
1E0C01
100C01
100C01
111111
